    Afrikaans: kaneelboom
    Arabic: قِرْفَة‎ f (qirfa)

        Hijazi Arabic: قرفة‎ (girfa)
        Moroccan Arabic: قرفة‎ (qarfa)

    Aramaic:

        Classical Syriac: ܕܪܨܝܢܝ‎ (dārṣīnī), ܨܝܢܕܪܓ‎ (ṣīndreḡ)

    Armenian: դարչին (hy) (darčʿin)
    Assamese: দালচেনি (dalseni)
    Azerbaijani: darçın (az)
    Basque: kanela
    Bengali: দারচিনি (darôcini), দারুচিনি (darucini)
    Bikol Central: kanela (bcl)
    Breton: gwez-kanell (collective)
    Bulgarian: кане́лено дърво́ n (kanéleno dǎrvó), кане́ла (bg) f (kanéla)
    Burmese: သစ်ကြံပိုးပင် (sackrampui:pang)
    Catalan: canyeller (ca) m, caneller m
    Chinese:

        Mandarin: 肉桂 (zh) (ròuguì), 桂皮 (zh) (guìpí)

    Czech: skořicovník m
    Dhivehi: ފޮނި ތޮށި‎ (foni toṣi)
    Dutch: kaneelboom (nl) m
    Esperanto: vera cinamomo (eo)
    Finnish: ceyloninkaneli, kanelipuu (fi)
    French: cannelier (fr) m
    Georgian: დარიჩინი (daričini)
    German: Zimtbaum (de) m
    Greek: κανέλα (el) f (kanéla)
    Gujarati: તજ (gu) (taj)
    Hebrew: קִנָּמוֹן‎ (he) m (qinnāmṓn)
    Hindi: दालचीनी (hi) (dālcīnī)
    Hungarian: fahéjfa (hu)
    Icelandic: kaniltré n, kanill (is) m
    Indonesian: kayumanis
    Italian: cannella (it) f

		

    Japanese: セイロン肉桂 (Seiron nikkei)
    Javanese: ꦏꦪꦸꦩꦤꦶꦱ꧀ (kayu manis)
    Kannada: ದಾಲ್ಚಿನ್ನಿ (kn) (dālcinni)
    Korean: 시나몬 (sinamon), 실론계피나무 (sillon'gyepinamu)
    Latin: cinnamōmum n, cinnamum n
    Malay: kayu manis
    Malayalam: കറുവ (ml) (kaṟuva)
    Maltese: kannella (mt) f
    Marathi: दालचीनी (dālcīnī)
    Mongolian: шанц (shants)
    Nepali: दालचिनी (ne) (dālacinī)
    Norwegian: kaneltre n
    Persian: دارچین‎ (fa) (dârčin)
    Polish: cynamonowiec (pl) m
    Portuguese: caneleira f
    Punjabi: दालचीनी
    Romanian: scorțișor (ro) m
    Russian: кори́чное де́рево n (koríčnoje dérevo)
    Serbo-Croatian:

        Cyrillic: цимет m
        Roman: cimet (sh) m

    Slovak: škoricovník (sk) m
    Spanish: canelo (es) m
    Swahili: mdalasini
    Swedish: äkta kanel c, kanel (sv) c
    Tagalog: kanela
    Tamil: இலவங்கப்பட்டை (ta) (ilavaṅkappaṭṭai), கருவாப்பட்டை (ta) (karuvāppaṭṭai), கறுவாப்பட்டை (kaṟuvāppaṭṭai)
    Thai: อบเชย (òp-chəəi)
    Tibetan: ཤིང་ཚ (shing tsha)
    Turkish: tarçın ağacı
    Vietnamese: cây quế
    Volapük: kirfatep, kirfatabim