    Arabic: فِلْفِل‎ (ar) m (filfil), فُلْفُل‎ (ar) m (fulful)

        Egyptian Arabic: فلفل حراق‎ m pl (felfel ḥaraʾ)

    Armenian: բիբար (hy) (bibar), պղպեղ (hy) (płpeł), տաքդեղ (hy) (takʿdeł)
    Assamese: জলকীয়া গছ (zolokia gos)
    Asturian: pimentera f
    Azerbaijani: bibər (az)
    Baluchi: مرچ‎ (mirc), پلپل‎ (pilpil)
    Bashkir: борос (boros)
    Bulgarian: пипер (bg) m (piper)
    Catalan: pebrer m
    Cherokee: ᏗᏆᏲᏙᏗ (diquayododi)
    Chinese:

        Cantonese: 胡椒 (wu4 ziu1)
        Mandarin: 胡椒 (zh) (hújiāo)

    Coptic: ⲡⲓⲡⲉⲣ (piper), ⲁⲗⲃⲟⲩⲗⲃⲟⲩⲗ (alboulboul)
    Crimean Tatar: biber
    Erzya: порцька (porcʹka)
    Estonian: pipar
    Finnish: pippuri (fi)
    French: poivrier (fr) m
    Galician: pemento (gl) m
    Georgian: წიწაკა (c̣ic̣aḳa)
    German: Pfeffer (de) m, Pfefferstrauch m
    Greek: πιπεριά (el) f (piperiá)

        Ancient: πέπερι n (péperi)

    Hebrew: פִּלְפֵּל‎ (he) m (pilpel), פִּלְפֶּלֶת‎ (he) f (pilpelet)
    Hindi: मिर्च (hi) (mirc)

		

    Hungarian: bors (hu)
    Ido: pipro (io)
    Indonesian: lada (id)
    Irish: piobar m
    Italian: peperone (it) m
    Japanese: 胡椒 (ja) (こしょう, koshō)
    Lao: ພິກໄທ (lo) (phik thai)
    Latin: piper n
    Latvian: pipars m
    Macedonian: бибер m (biber), црн пипер m (crn piper)
    Persian: فلفل‎ (fa) (felfel)
    Polish: pieprz (pl) m
    Portuguese: pimenta (pt), pimenteiro m
    Romanian: piper (ro) m
    Russian: пе́рец (ru) m (pérec)
    Serbo-Croatian:

        Roman: pȁpar (sh) m

    Shona: mhiripiri
    Spanish: pimentero (es)
    Swahili: mpilipili (sw)
    Swedish: pepparväxt c
    Tagalog: paminta
    Turkish: biber (tr)
    Turkmen: burc
    Uzbek: qalampir (uz)
    Vietnamese: tiêu (vi)
    Walloon: poevrî m
    Zulu: upelepele (zu)