    Afrikaans: peper m
    Akan: moko
    Albanian: piper (sq) m
    Amharic: በርበሬ (bärbäre)
    Arabic: فِلْفِل‎ (ar) m (filfil), فُلْفُل‎ (ar) m (fulful)

        Egyptian Arabic: فلفل‎ m pl (felfel)
        Moroccan Arabic: بزار‎ m (bzār), إبزار‎ m (ʔibzār)

    Archi: пилпил
    Armenian: բիբար (hy) (bibar), պղպեղ (hy) (płpeł), տաքդեղ (hy) (takʿdeł)
    Aromanian: piper
    Assamese: জলকীয়া (zolokia)
    Asturian: pimientu (ast) m
    Atayal: mlúh
    Avar: пилпил (pilpil)
    Azerbaijani: bibər (az)
    Baluchi: مرچ‎ (mirc), پلپل‎ (pilpil)
    Bashkir: борос (boros)
    Basque: piperra
    Belarusian: пе́рац m (pjérac)
    Bengali: মরিচ (môric)
    Bulgarian: пи́пер (bg) m (píper)
    Burmese: ငရုတ်ကောင်း (my) (nga.rutkaung:)
    Catalan: pebre (ca) m
    Chechen: бурч (burč)
    Cherokee: ᏗᏆᏲᏙᏗ (diquayododi)
    Chinese:

        Cantonese: 胡椒 (wu4 ziu1), 胡椒粉 (wu4 ziu1 fan2) (ground)
        Hakka: 胡椒 (fù-chêu)
        Mandarin: 胡椒 (zh) (hújiāo)

    Coptic: ⲡⲓⲡⲉⲣ (piper), ⲁⲗⲃⲟⲩⲗⲃⲟⲩⲗ (alboulboul)
    Crimean Tatar: biber
    Czech: pepř (cs) m
    Dalmatian: pepro m
    Danish: peber n
    Dhivehi: އަސޭމިރުސް‎ (asēmirus)
    Dutch: peper (nl) m
    Elfdalian: pipär m
    Esperanto: pipro
    Estonian: pipar
    Faroese: pipar n
    Finnish: pippuri (fi)
    French: poivre (fr) m
    Friulian: pevar
    Galician: pimenta (gl) f
    Georgian: პილპილი (ṗilṗili), წიწაკა (c̣ic̣aḳa)
    German: Pfeffer (de) m
    Greek: πιπέρι (el) n (pipéri)

        Ancient: πέπερι n (péperi)

    Greenlandic: qasilitsut pl
    Haitian Creole: piman
    Hebrew: פִּלְפֵּל‎ (he) m (pilpel), פִּלְפֵּל שָׁחֹר‎ (he) m (pilpel shakhor) (black pepper)
    Hindi: मिर्च (hi) m (mirc)
    Hungarian: bors (hu)
    Hunsrik: Peffer m
    Icelandic: pipar (is) m
    Ido: pipro (io)
    Indonesian: merica (id), lada (id)
    Irish: piobar m
    Italian: pepe (it) m
    Jamaican Creole: peppa
    Japanese: 胡椒 (ja) (こしょう, koshō)
    Javanese: mrica (jv)
    Kannada: ಕರಿಮೆಣಸು (kn) (karimeṇasu), ಮೆಣಸು (kn) (meṇasu)
    Kavalan: mǝnnə́t
    Kazakh: бұрыш (kk) (burış)
    Khmer: ម្រេច (km) (mrɨc)
    Korean: 고추 (ko) (gochu), 후추 (ko) (huchu)
    Kurdish:

        Northern Kurdish: filfil (ku)

    Kyrgyz: мурч (murç)
    Lao: ພິກໄທ (lo) (phik thai)
    Latin: piper n
    Latvian: pipari m pl
    Lingala: pilipilí
    Lithuanian: piparas m
    Lombard: pever m, pevre m

		

    Low German: Peper (nds) m
    Luxembourgish: Peffer (lb) m
    Lü: ᦘᦲᧅ (phiik)
    Macedonian: бибер m (biber), црн пипер m (crn piper)
    Malay: lada (ms)
    Malayalam: കുരുമുളക് (ml) (kurumuḷakŭ)
    Maltese: bżar m
    Manx: pibbyr m
    Maori: pepa
    Mongolian: перц (perts)
    Mòcheno: pever m
    Navajo: azeedíchʼííʼ łibáhí
    Norman: paîvre m
    North Frisian: (Föhr-Amrum) pöber n
    Northern Sami: bihppor
    Norwegian: pepper (no) n
    Occitan: pebre (oc)
    Old Church Slavonic:

        Cyrillic: пьпьрь m (pĭpĭrĭ)

    Old East Slavic: пьпьрь m (pĭpĭrĭ) (12th century), перець m (perecĭ) (14th century)
    Old Frisian: piper
    Old Javanese: marica
    Ossetian: цывзы (cyvzy), бырц (byrc)
    Paiwan: mácam
    Persian: فلفل‎ (fa) (felfel)
    Polish: pieprz (pl) m
    Portuguese: pimenta (pt) f
    Puyuma: naná
    Quechua: piminta
    Romanian: piper (ro) m
    Romansch: paiver, peiver, pever
    Russian: пе́рец (ru) m (pérec), чёрный пе́рец m (čórnyj pérec) (black pepper)
    Sanskrit: मरीचम् (sa) m (marīcam)
    Sardinian: pibere, pibiri, pipere
    Scottish Gaelic: piobar m
    Serbo-Croatian:

        Cyrillic: бибер m, папар m
        Roman: biber (sh) m, pаpаr m

    Shan: please add this translation if you can
    Shona: mhiripiri
    Sicilian: pipi (scn)
    Slovak: korenie n, piepor m
    Slovene: poper (sl) m
    Sorbian:

        Lower Sorbian: peṕeŕ m, per m
        Upper Sorbian: popjeŕ m

    Spanish: pimienta (es) f
    Sundanese: pedes (su)
    Swahili: pilipili manga
    Swedish: peppar (sv) c
    Tajik: филфил (tg) (filfil), мурч (murč)
    Tamil: மிளகு (ta) (miḷaku)
    Tatar: борыч (tt) (borıç)
    Telugu: మిరియము (te) (miriyamu)
    Thai: พริกไทย (prík-tai)
    Thao: makámun
    Tigrinya: በርበረ (bärbärä)
    Tlingit: si.áax'u at
    Tok Pisin: pepa
    Tonkawa: mummunchicew
    Turkish: karabiber (tr)
    Turkmen: burc
    Ukrainian: пе́рець m (pérecʹ)
    Urdu: مرچ‎ m (mirc)
    Uyghur: مۇچ‎ (much)
    Uzbek: qalampir (uz), murch (uz)
    Venetian: pévaro
    Vietnamese: tiêu (vi)
    Volapük: pep (vo)
    Walloon: poeve (wa) m
    Welsh: pupur (cy) m, bupur m
    West Frisian: piper
    Yiddish: פֿעפֿער‎ m (fefer)
    Yoruba: ata
    Yup'ik: piilitsaaq
    Zhuang: lwgmanh
    Zulu: upelepele (zu)